(16, 16)
p#___#____######
_#_#_#_##_#_#__#
_#_#____#_#____#
___#_####___#___
####_#####_###_#
___#_#_____#_###
_____#_#####_#_#
######__________
_____#_#########
________#_______
_########_######
______________#_
###########_#_#_
____________#_#_
__###########_#_
#_____#f________