(16, 16)
p#   #    ######
 # # # ## # #  # 
 # #    # #    # 
   # ####   #    
#### ##### ### # ########
   # #     # ### 
     # ##### # # 
######           
     # ######### 
        #        
 ######## ######  
              #   
########### # #   
            # #  
  ########### #  
#     #f        
